C 9,9,15
F 100,20,29

NO ./assets/giant.xpm
SO ./assets/NO_test.xpm
EA ./assets/giant.xpm
WE ./assets/giant.xpm

111111111111111111111111111111
100000000000000000000000000001
100000000000000000000000000001
100000000000000100000000000001
100000000000000100000000000001
100000000000000100000000000001
111111111100111111111111111111
100000000000000100000000000001
100000000000000100000000000001
100000000000000100000000000001
100000000000000000000000000001
100000000000000100000000000001
100000000000000100000000000001
100000000000000100000000000001
101111111111111111111000111111
100000000000000100000000000001
100000000000000100000000000001
100000000000000100000000000001
100000000000000100000000000001
100000000000000100000000000001
100000000000000100000000000001
100000000000000100000000000001
100000000000000100000000000001
111111111111111111111100011111
100000000000000100000000000001
100000000000000100000000000001
100000000000000000000000000001
1000000E0000000100000000000001
100000000000000100000000000001
111111111111111111111111111111
