NO ./srcs/textures/ultravisitor.xpm
SO ./srcs/textures/hello-everything.xpm
WE ./srcs/textures/damogen.xpm
EA ./srcs/textures/hardnormaldaddy.xpm

F 88,185,71
C 126,201,237

 111111111111  1111111
 111000000001111000001
 100000110001000000001
 111000110001000111111111111111
   10001100000000000000000000001
  110000001110000000000000000001
  100000001000000111111110000001
  1000000000000001      10000001
  1000000000000001      10000001
  1000000000000001      110000E01
  100000001000000111111110000001
  10000001 100000000000000000001
  10000000100000111111111111111
  11111111111111
