NO ./srcs/textures/ultravisitor.xpm
WE ./srcs/textures/damogen.xpm
EA ./srcs/textures/hello-everything.xpm
SO ./srcs/textures/hardnormaldaddy.xpm

C 0,43,23
F 255,2,3

111111111111111111111111111111111111111111
100111111111111000000000000000000000000001
1001111111111110000000000000000000000000011
11111111111111111111001111000000000000000011 
                   1001 111111111110100101011111111111
   1111111111111   1001 100000100010100000000000000111111111111111111111111111111111111111111111111
   1111111111111   1001 100000100010100100010000000000000000000000000000000000000000000000000000001
   1111111111111   1001 100000100010100000000000000000000000000000000000000000000000000000000000001
   1111111111111   1001 100000110110100101010000000000000000000000000000000000000000000000000000001
   1111111111111   1001 100000000000000000000000000000000000000000000000000000000000000000000000001
   1111111111111   1001 101111000000000000000001110101010000000100110000000000000000000000000000111
   1111111111111   1001 101  10000000000000000010100000000101010101010000000000000000000000000001
   1111   111111   1001 101  10000000000000000010000000000000000000000000000000000000000000111111
   1111111111111   1001 1011110000000000000000E000000000000000000000000000000000000000000001
   1111111111111   1001 10000000000000000000000100000000000000000000000000000000000000000001
   1111111111111   1001 10000000000010100000101100000000000000000000000000000000000000000001                              1111
   1111111111111   1001 111111111000101000011011000111110111000000000000000000000000000000011111111111111111111111111111111001
   1111111111111   1001 110100001000101000000000000000000001000000000000000000000000000000000000000000000000000000000000000001
   1111111111111   1001 110000001000101000011011000111111111000000000000000000000000000000000000000000000000000000000000000001
                   1001 110100001000101000001010000000000000000000000000000000000000000000000000000000000000000000000000000001
                   1001 110111111000101000000000000000111111111111111111111111111111000000000000000000000000000000000000000001
111111111111111111110011110000000000101000000000000000000000000000000000000000000000000000000000000000000000000000000000000001
100000000000000000000000000000000000101000000000000000000000000000000000000000000000000000000000000000000000000000000000000001
111111111111111111111111111111111111000000000000000001111111111111111111111111111111111111111111111111111111111111111111111111
                                   10000000000000000011
                                   110000000000000000011
                                    11000000000000000001
                                     1000000000000000001
                                     1000000000000000001
                                     1000000000000000001
                                     1000000000000000001
                                     1111111111111111111
