C 25,21,221
F 255,255,255

EA ./xpm/eagle.xpm
SO ./xpm/greystone.xpm
WE ./xpm/purplestone.xpm
NO ./xpm/red.xpm

111111111111111    111111111 
10000010001001     100000001
100001011111001    100000011
1000011111111111111111100001
1001111      11110000000011111111
1000101      10000000111110000011
100000111111110000000001111100001
100000000000000000010000011111001
111111111111111111110000000000001
                  100000111000111
                  1N0000001000011
                  11111111111111
