C   225,30,0




F     25,,,,,,,,100,0

EA     ./xpm/eagle.xpm
SO   ./xpm/greystone.xpm
WE                     ./xpm/purplestone.xpm
NO    ./xpm/red.xpm


11111               
      11001111
    10101     
 10   10111111
101   01111111
1011   111110 
10101  N  11011
11111111111111
111111111111111
11111111111111111
