C 9,9,15
F 100,20,29

NO ./assets/giant.xpm
SO ./assets/NO_test.xpm
EA ./assets/giant.xpm
WE ./assets/giant.xpm

11111111111111
10000000000001
10000000000001
10000000000001
10000000000001
1000000N000001
11111111111111
