C 0,255,0
F 0,0,255

NO ./assets/NO_test.xpm
SO ./assets/NO_test.xpm
EA ./assets/NO_test.xpm
WE ./assets/NO_test.xpm

11111
11011
10N01
11011
11111
