C 9,9,15
F 100,20,29

NO ./assets/giant.xpm
SO ./assets/NO_test2.xpm
EA ./assets/EA_test.xpm
WE ./assets/WE_test.xpm

11111111111111      111111111
10000000000001      10000000111111111111111111111111111111111111111111111111111111111111111111111111111111111111111111111111111111111111111
10000100000001      10111100000000000000000000000000000000000000000000000000000000000000000000000000000000000000000000000000000000000000001
11000100000001      10011100111111111111111111111111111111111111111111111110000000000000000000000000000000000000000000000000000000000000001
10001111111001      100011001                                             10000000000000000000000000000000000000000000000000000000000000001
10101000100001111111100001111                                             10000000000000000000000000000000000000000000001111111111111111111
10001000100000000000000000001                                             10000000000000000000000000000000000000000000001111111111111111111
10001000100000000000000000001                                             10000000000000000000000000000000000000000000001111111111111111111
10001000000001111111111111111                                             10000000000000000000000001111111111111111111111111111111111111111
10001111111111                                                            10000000000000011111110001
10001100000001                                                            1000000000000001     10001     111111111111
10000000000001                                                            1000000000000001     10001     100000000001
10011111110111                                                            1000000000000001     11101     111100000001
10000000010001                                                            1000000000000001     10001        100000001
11111100010001                                                            1000000000000001111111000111111111111111001
10000000010001                                                            1000000000000000000000000000000000000000001
1000000N010001                                                            1111111111111111111111111111111111111111111
11111111111111
