





C 16,16,16

F 255,255,255







EA ./xpm/eagle.xpm
SO ./xpm/greystone.xpm
WE ./xpm/purplestone.xpm
NO ./xpm/red.xpm

11111111111111111111                      1111111111111111111
10000000000000000001                      10001111111111
10000111111111100001                       1011111111111111111111111
100001        100001                       1011111111111111111
10000111111111100001111111111111111111111111N11111111111111111
1000000000000000000000000000000000000000000000000000000000000111
11111111111111111111111111111111111111111111111111111111111111
