





C 16,16,16

F 255,255,255



EA ./assets/EA_test.xpm
SO ./assets/SO_test.xpm
WE ./assets/WE_test.xpm
NO ./assets/NO_test.xpm




11111111111111111111                      1111111111111111111
10000000000000000001                      10001111111111
10000111111111100001                       1011111111111111111111111
100001        100001                       1011111111111111111
10000111111111100001111111111111111111111111011111111111111111
100000000000000000000000000000000000000000000000000000000000N111
11111111111111111111111111111111111111111111111111111111111111
