C 64,32,127
F 64,127,32

EA ./assets/EA_test.xpm
SO ./assets/NO_test2.xpm
WE ./assets/WE_test.xpm
NO ./assets/NO_test.xpm

111111111111111    111111111 
10000010001001     100000001
100001011111001    100000011
1000011111111111111111100001
1001111      11110000000011111111
1000101      10000000111110000011
100000111111110000000001111111001
100000000000000000010000011100001
111111111111111111110000000000001
                  1001000111000111
                  100N10001000011
                   111111111111
