C 25,21,221
F 255,255,255

EA ./xpm/eagle.xpm
SO ./xpm/greystone.xpm
WE ./xpm/purplestone.xpm
NO ./xpm/red.xpm

111111111111111
100001010001001
100001011111001
10000111000100111111111111111
1001110111111110000000010000011111
1000100000000000000001111100000011
1N0000011111000000000001111100001
111111111111111111111111111111111
