SO ./srcs/textures/ultravisitor.xpm
NO ./srcs/textures/hello-everything.xpm
EA ./srcs/textures/damogen.xpm
WE ./srcs/textures/hardnormaldaddy.xpm

F 88,185,71
C 126,201,237


 1 1111111111  1111111
 111000000001111000001
  10000110001000000001
 111000110001000111111
   10001100000001
  11000000111000011
  1000011110000001
  100001W000100001
  1000111100100001 
  1000011100000001
  100001 100000001
1 1000111100000001111111111111111111            
1000000010000000000000000000001
11100000000000001111111111111111
  111111111111111
